11111111111111111111111111111111111111111111111111
1000000000P111111111111111111111111111111111111111
11110111111111111111111111111111111111111111111111
10000000CCCC11111111111111111111111111111111111111
10000011111111111111111111111111111111111111111111
11001100000011111111111111111111111111111111111111
11101111111111111111111111111111111111111111111111
11101111111111111111111111111111111111111111111111
10000000000C11111111111111111111111111111111111111
1E000011110111111111111111111111111111111111111111
11111111111111111111111111111111111111111111111111
